NO ./img/north.png
SO ./img/south.png
WE ./img/west.png
EA ./img/east.png
F 220,100,0
C 225,30,0
        1111111111111111111111111
        1000000000110000000008001
        1011012101110000S00010001
        10010000000000000000200021
111111111011000001110808800010001
100000000011000001110121111111111
11110111111111011100000010001
111101111111110111010100100011111
11000000110101011100000010001
10000000000000001100000000001
10000000000000001101010010001
11000001110101011111011110011111111
11110111 1110101 101111010000000001
11111111 1111111 111111111111111111





