NO ./img/north.png
SO ./img/south.png
WE ./img/west.png
EA ./img/east.png
F 220,100,0
C 225,30,0
1111111111111111111111111
1000000000110000000000001
1011002001110000S00010001
10010000000000000000200021
10010000000000000000200021
1111111111111111111111111
