NO ./img/north.png
SO ./img/south.png
WE ./img/west.png
EA ./img/east.png

F 200,100,0


 11111111
 10000001
10N011111
11111
