1111111111111
10CCCCCCCCC01
111100000CCE1
10C0C0C00C0C1
10C01110C0C01
10C0C0CP0CCC1
1111111111111
