11111
1P001
10C01
11001
11101
100E1
11111
