111111111111
1E0000000001
1000P0000001
110000000001
100000011111
1000C00100C1
111111111111
