NO ./img/north.png
SO ./img/south.png
WE ./img/west.png
EA ./img/east.png
F 255,100,0
C 225,230,000
        1111111111111111111111111
        1000000000110000000000001
        101100000111000080000001
        1001000800200088888800001
111111111011000001110000000000E1
100000000002000001110111112111111
11110111111111011100000010001
11000000110101011100000010001
10000000008000001100000010001111111
10880000000000001101010010001
1100000111010101111101111000111
11110111 1110101 101111010001
11111111 1111111 111111111111
