NO ./img/north.png
SO ./img/south.png
WE ./img/west.png
EA ./img/east.png
F 255,100,0
C 225,230,000

11111111 11111111 111111111111
1110111
10E01                        
11111
